#NCBI Taxonomy	GTDB Taxonomy
r__Root	r__Root
r__Root; d__Archaea	r__Root; d__Archaea
r__Root; d__Archaea; p__Candidatus Bathyarchaeota	d__Archaea; p__Thermoproteota; c__Bathyarchaeia
r__Root; d__Archaea; p__Candidatus Helarchaeota	d__Archaea; p__Asgardarchaeota; c__Lokiarchaeia; o__Helarchaeales
r__Root; d__Archaea; p__Candidatus Verstraetearchaeota	d__Archaea; p__Thermoproteota
r__Root; d__Archaea; p__Candidatus Verstraetearchaeota; c__Candidatus Methanomethylia; o__Candidatus Methanomethyliales	d__Archaea; p__Thermoproteota; c__Methanomethylicia; o__Methanomethylicales
r__Root; d__Archaea; p__Candidatus Verstraetearchaeota; c__Candidatus Methanomethylia; o__Candidatus Methanomethyliales; f__Candidatus Methanomethyliaceae	d__Archaea; p__Thermoproteota; c__Methanomethylicia; o__Methanomethylicales; f__Methanomethylicaceae
r__Root; d__Archaea; p__Candidatus Verstraetearchaeota; c__Candidatus Methanomethylia; o__Candidatus Methanomethyliales; f__Candidatus Methanomethyliaceae; g__Candidatus Methanomethylicus	d__Archaea; p__Thermoproteota; c__Methanomethylicia; o__Methanomethylicales; f__Methanomethylicaceae; g__Methanomethylicus
r__Root; d__Archaea; p__Candidatus Verstraetearchaeota; c__Candidatus Methanomethylia; o__Candidatus Methanomethyliales; f__Candidatus Methanomethyliaceae; g__Candidatus Methanosuratus	d__Archaea; p__Thermoproteota; c__Methanomethylicia; o__Methanomethylicales; f__Methanomethylicaceae; g__Methanosuratus
r__Root; d__Archaea; p__Crenarchaeota	d__Archaea; p__Thermoproteota
r__Root; d__Archaea; p__Euryarchaeota	d__Archaea
r__Root; d__Archaea; p__Euryarchaeota; c__Archaeoglobi	d__Archaea; p__Halobacteriota; c__Archaeoglobi
r__Root; d__Archaea; p__Euryarchaeota; c__Archaeoglobi; o__Archaeoglobales	d__Archaea; p__Halobacteriota; c__Archaeoglobi; o__Archaeoglobales
r__Root; d__Archaea; p__Euryarchaeota; c__Archaeoglobi; o__Archaeoglobales; f__Archaeoglobaceae	d__Archaea; p__Halobacteriota; c__Archaeoglobi; o__Archaeoglobales; f__Archaeoglobaceae
r__Root; d__Archaea; p__Euryarchaeota; c__Archaeoglobi; o__Archaeoglobales; f__Archaeoglobaceae; g__Archaeoglobus	d__Archaea; p__Halobacteriota; c__Archaeoglobi; o__Archaeoglobales; f__Archaeoglobaceae; g__Archaeoglobus
r__Root; d__Archaea; p__Euryarchaeota; c__Candidatus Methanofastidiosa	d__Archaea; p__Methanobacteriota; c__Thermococci; o__Methanofastidiosales; f__Methanofastidiosaceae; g__Methanofastidiosum
r__Root; d__Archaea; p__Euryarchaeota; c__Hadesarchaea	d__Archaea; p__Hadarchaeota; c__Hadarchaeia; o__Hadarchaeales
r__Root; d__Archaea; p__Euryarchaeota; c__Methanobacteria; o__Methanobacteriales; f__Methanobacteriaceae	d__Archaea; p__Methanobacteriota; c__Methanobacteria; o__Methanobacteriales; f__Methanobacteriaceae
r__Root; d__Archaea; p__Euryarchaeota; c__Methanobacteria; o__Methanobacteriales; f__Methanobacteriaceae; g__Methanobacterium	d__Archaea; p__Methanobacteriota; c__Methanobacteria; o__Methanobacteriales; f__Methanobacteriaceae
r__Root; d__Archaea; p__Euryarchaeota; c__Methanobacteria; o__Methanobacteriales; f__Methanobacteriaceae; g__Methanobacterium; s__Methanobacterium congolense	d__Archaea; p__Methanobacteriota; c__Methanobacteria; o__Methanobacteriales; f__Methanobacteriaceae; g__Methanobacterium_C; s__Methanobacterium_C congolense
r__Root; d__Archaea; p__Euryarchaeota; c__Methanobacteria; o__Methanobacteriales; f__Methanobacteriaceae; g__Methanobacterium; s__Methanobacterium lacus	d__Archaea; p__Methanobacteriota; c__Methanobacteria; o__Methanobacteriales; f__Methanobacteriaceae; g__Methanobacterium_B; s__Methanobacterium_B lacus
r__Root; d__Archaea; p__Euryarchaeota; c__Methanobacteria; o__Methanobacteriales; f__Methanobacteriaceae; g__Methanobacterium; s__Methanobacterium paludis	d__Archaea; p__Methanobacteriota; c__Methanobacteria; o__Methanobacteriales; f__Methanobacteriaceae; g__Methanobacterium_C; s__Methanobacterium_C paludis
r__Root; d__Archaea; p__Euryarchaeota; c__Methanobacteria; o__Methanobacteriales; f__Methanobacteriaceae; g__Methanobacterium; s__Methanobacterium sp. BRmetb2	d__Archaea; p__Methanobacteriota; c__Methanobacteria; o__Methanobacteriales; f__Methanobacteriaceae; g__UBA117; s__UBA117 sp002494785
r__Root; d__Archaea; p__Euryarchaeota; c__Methanobacteria; o__Methanobacteriales; f__Methanobacteriaceae; g__Methanobacterium; s__Methanobacterium sp. MB1	d__Archaea; p__Methanobacteriota; c__Methanobacteria; o__Methanobacteriales; f__Methanobacteriaceae; g__Methanobacterium; s__Methanobacterium sp000499765
r__Root; d__Archaea; p__Euryarchaeota; c__Methanobacteria; o__Methanobacteriales; f__Methanobacteriaceae; g__Methanobacterium; s__Methanobacterium sp. Maddingley MBC34	d__Archaea; p__Methanobacteriota; c__Methanobacteria; o__Methanobacteriales; f__Methanobacteriaceae; g__Methanobacterium; s__Methanobacterium sp000309865
r__Root; d__Archaea; p__Euryarchaeota; c__Methanobacteria; o__Methanobacteriales; f__Methanobacteriaceae; g__Methanobacterium; s__Methanobacterium sp. SMA-27	d__Archaea; p__Methanobacteriota; c__Methanobacteria; o__Methanobacteriales; f__Methanobacteriaceae; g__Methanobacterium_B; s__Methanobacterium_B sp000744455
r__Root; d__Archaea; p__Euryarchaeota; c__Methanobacteria; o__Methanobacteriales; f__Methanobacteriaceae; g__Methanobacterium; s__Methanobacterium subterraneum	d__Archaea; p__Methanobacteriota; c__Methanobacteria; o__Methanobacteriales; f__Methanobacteriaceae; g__Methanobacterium; s__Methanobacterium subterraneum
r__Root; d__Archaea; p__Euryarchaeota; c__Methanobacteria; o__Methanobacteriales; f__Methanobacteriaceae; g__Methanobrevibacter	d__Archaea; p__Methanobacteriota; c__Methanobacteria; o__Methanobacteriales; f__Methanobacteriaceae
r__Root; d__Archaea; p__Euryarchaeota; c__Methanobacteria; o__Methanobacteriales; f__Methanobacteriaceae; g__Methanobrevibacter; s__Methanobrevibacter arboriphilus	d__Archaea; p__Methanobacteriota; c__Methanobacteria; o__Methanobacteriales; f__Methanobacteriaceae; g__Methanobrevibacter_C; s__Methanobrevibacter_C arboriphilus
r__Root; d__Archaea; p__Euryarchaeota; c__Methanobacteria; o__Methanobacteriales; f__Methanobacteriaceae; g__Methanobrevibacter; s__Methanobrevibacter curvatus	d__Archaea; p__Methanobacteriota; c__Methanobacteria; o__Methanobacteriales; f__Methanobacteriaceae; g__Methanobrevibacter_D; s__Methanobrevibacter_D curvatus
r__Root; d__Archaea; p__Euryarchaeota; c__Methanobacteria; o__Methanobacteriales; f__Methanobacteriaceae; g__Methanobrevibacter; s__Methanobrevibacter cuticularis	d__Archaea; p__Methanobacteriota; c__Methanobacteria; o__Methanobacteriales; f__Methanobacteriaceae; g__Methanobrevibacter_C; s__Methanobrevibacter_C cuticularis
r__Root; d__Archaea; p__Euryarchaeota; c__Methanobacteria; o__Methanobacteriales; f__Methanobacteriaceae; g__Methanobrevibacter; s__Methanobrevibacter filiformis	d__Archaea; p__Methanobacteriota; c__Methanobacteria; o__Methanobacteriales; f__Methanobacteriaceae; g__Methanobrevibacter_D; s__Methanobrevibacter_D filiformis
r__Root; d__Archaea; p__Euryarchaeota; c__Methanobacteria; o__Methanobacteriales; f__Methanobacteriaceae; g__Methanobrevibacter; s__Methanobrevibacter millerae	d__Archaea; p__Methanobacteriota; c__Methanobacteria; o__Methanobacteriales; f__Methanobacteriaceae; g__Methanobrevibacter_A; s__Methanobrevibacter_A millerae
r__Root; d__Archaea; p__Euryarchaeota; c__Methanobacteria; o__Methanobacteriales; f__Methanobacteriaceae; g__Methanobrevibacter; s__Methanobrevibacter olleyae	d__Archaea; p__Methanobacteriota; c__Methanobacteria; o__Methanobacteriales; f__Methanobacteriaceae; g__Methanobrevibacter; s__Methanobrevibacter olleyae
r__Root; d__Archaea; p__Euryarchaeota; c__Methanobacteria; o__Methanobacteriales; f__Methanobacteriaceae; g__Methanobrevibacter; s__Methanobrevibacter oralis	d__Archaea; p__Methanobacteriota; c__Methanobacteria; o__Methanobacteriales; f__Methanobacteriaceae; g__Methanobrevibacter_A; s__Methanobrevibacter_A oralis
r__Root; d__Archaea; p__Euryarchaeota; c__Methanobacteria; o__Methanobacteriales; f__Methanobacteriaceae; g__Methanobrevibacter; s__Methanobrevibacter ruminantium	d__Archaea; p__Methanobacteriota; c__Methanobacteria; o__Methanobacteriales; f__Methanobacteriaceae; g__Methanobrevibacter; s__Methanobrevibacter ruminantium
r__Root; d__Archaea; p__Euryarchaeota; c__Methanobacteria; o__Methanobacteriales; f__Methanobacteriaceae; g__Methanobrevibacter; s__Methanobrevibacter smithii	d__Archaea; p__Methanobacteriota; c__Methanobacteria; o__Methanobacteriales; f__Methanobacteriaceae; g__Methanobrevibacter_A; s__Methanobrevibacter_A smithii
r__Root; d__Archaea; p__Euryarchaeota; c__Methanobacteria; o__Methanobacteriales; f__Methanobacteriaceae; g__Methanobrevibacter; s__Methanobrevibacter sp. AbM4	d__Archaea; p__Methanobacteriota; c__Methanobacteria; o__Methanobacteriales; f__Methanobacteriaceae; g__Methanobrevibacter_B; s__Methanobrevibacter_B boviskoreani
r__Root; d__Archaea; p__Euryarchaeota; c__Methanobacteria; o__Methanobacteriales; f__Methanobacteriaceae; g__Methanobrevibacter; s__Methanobrevibacter sp. D5	d__Archaea; p__Methanobacteriota; c__Methanobacteria; o__Methanobacteriales; f__Methanobacteriaceae
r__Root; d__Archaea; p__Euryarchaeota; c__Methanobacteria; o__Methanobacteriales; f__Methanobacteriaceae; g__Methanobrevibacter; s__Methanobrevibacter sp. YE315	d__Archaea; p__Methanobacteriota; c__Methanobacteria; o__Methanobacteriales; f__Methanobacteriaceae; g__Methanobrevibacter_A; s__Methanobrevibacter_A sp001548675
r__Root; d__Archaea; p__Euryarchaeota; c__Methanobacteria; o__Methanobacteriales; f__Methanobacteriaceae; g__Methanobrevibacter; s__Methanobrevibacter wolinii	d__Archaea; p__Methanobacteriota; c__Methanobacteria; o__Methanobacteriales; f__Methanobacteriaceae; g__Methanobrevibacter_B; s__Methanobrevibacter_B wolinii
r__Root; d__Archaea; p__Euryarchaeota; c__Methanobacteria; o__Methanobacteriales; f__Methanobacteriaceae; g__Methanosphaera; s__Methanosphaera cuniculi	d__Archaea; p__Methanobacteriota; c__Methanobacteria; o__Methanobacteriales; f__Methanobacteriaceae; g__Methanosphaera; s__Methanosphaera cuniculi
r__Root; d__Archaea; p__Euryarchaeota; c__Methanobacteria; o__Methanobacteriales; f__Methanobacteriaceae; g__Methanosphaera; s__Methanosphaera sp. BMS	d__Archaea; p__Methanobacteriota; c__Methanobacteria; o__Methanobacteriales; f__Methanobacteriaceae; g__Methanosphaera; s__Methanosphaera sp003268005
r__Root; d__Archaea; p__Euryarchaeota; c__Methanobacteria; o__Methanobacteriales; f__Methanobacteriaceae; g__Methanosphaera; s__Methanosphaera sp. ISO3-F5	d__Archaea; p__Methanobacteriota; c__Methanobacteria; o__Methanobacteriales; f__Methanobacteriaceae; g__Methanosphaera
r__Root; d__Archaea; p__Euryarchaeota; c__Methanobacteria; o__Methanobacteriales; f__Methanobacteriaceae; g__Methanosphaera; s__Methanosphaera stadtmanae	d__Archaea; p__Methanobacteriota; c__Methanobacteria; o__Methanobacteriales; f__Methanobacteriaceae; g__Methanosphaera; s__Methanosphaera stadtmanae
r__Root; d__Archaea; p__Euryarchaeota; c__Methanobacteria; o__Methanobacteriales; f__Methanobacteriaceae; g__Methanothermobacter; s__Methanothermobacter sp. KEPCO-1	d__Archaea; p__Methanobacteriota; c__Methanobacteria; o__Methanobacteriales; f__Methanothermobacteraceae; g__Methanothermobacter
r__Root; d__Archaea; p__Euryarchaeota; c__Methanobacteria; o__Methanobacteriales; f__Methanobacteriaceae; g__Methanothermobacter; s__Methanothermobacter sp. MT-2	d__Archaea; p__Methanobacteriota; c__Methanobacteria; o__Methanobacteriales; f__Methanothermobacteraceae_A; g__Methanothermobacter_A; s__Methanothermobacter_A sp003584625
r__Root; d__Archaea; p__Euryarchaeota; c__Methanobacteria; o__Methanobacteriales; f__Methanobacteriaceae; g__Methanothermobacter; s__Methanothermobacter thermautotrophicus	d__Archaea; p__Methanobacteriota; c__Methanobacteria; o__Methanobacteriales; f__Methanothermobacteraceae; g__Methanothermobacter; s__Methanothermobacter thermautotrophicus
r__Root; d__Archaea; p__Euryarchaeota; c__Methanobacteria; o__Methanobacteriales; f__Methanobacteriaceae; g__Methanothermobacter; s__Methanothermobacter wolfeii	d__Archaea; p__Methanobacteriota; c__Methanobacteria; o__Methanobacteriales; f__Methanothermobacteraceae; g__Methanothermobacter; s__Methanothermobacter wolfeii
r__Root; d__Archaea; p__Euryarchaeota; c__Methanobacteria; o__Methanobacteriales; f__Methanothermaceae; g__Methanothermus; s__Methanothermus fervidus	d__Archaea; p__Methanobacteriota; c__Methanobacteria; o__Methanobacteriales; f__Methanothermaceae; g__Methanothermus; s__Methanothermus fervidus
r__Root; d__Archaea; p__Euryarchaeota; c__Methanococci; o__Methanococcales	d__Archaea; p__Methanobacteriota; c__Methanococci; o__Methanococcales
r__Root; d__Archaea; p__Euryarchaeota; c__Methanococci; o__Methanococcales; f__Methanocaldococcaceae; g__Methanocaldococcus; s__Methanocaldococcus bathoardescens	d__Archaea; p__Methanobacteriota; c__Methanococci; o__Methanococcales; f__Methanocaldococcaceae; g__Methanocaldococcus; s__Methanocaldococcus bathoardescens
r__Root; d__Archaea; p__Euryarchaeota; c__Methanococci; o__Methanococcales; f__Methanocaldococcaceae; g__Methanocaldococcus; s__Methanocaldococcus fervens	d__Archaea; p__Methanobacteriota; c__Methanococci; o__Methanococcales; f__Methanocaldococcaceae; g__Methanocaldococcus; s__Methanocaldococcus fervens
r__Root; d__Archaea; p__Euryarchaeota; c__Methanococci; o__Methanococcales; f__Methanocaldococcaceae; g__Methanocaldococcus; s__Methanocaldococcus villosus	d__Archaea; p__Methanobacteriota; c__Methanococci; o__Methanococcales; f__Methanocaldococcaceae; g__Methanocaldococcus_A; s__Methanocaldococcus_A villosus
r__Root; d__Archaea; p__Euryarchaeota; c__Methanococci; o__Methanococcales; f__Methanocaldococcaceae; g__Methanocaldococcus; s__Methanocaldococcus vulcanius	d__Archaea; p__Methanobacteriota; c__Methanococci; o__Methanococcales; f__Methanocaldococcaceae; g__Methanocaldococcus; s__Methanocaldococcus vulcanius
r__Root; d__Archaea; p__Euryarchaeota; c__Methanococci; o__Methanococcales; f__Methanocaldococcaceae; g__Methanotorris; s__Methanotorris formicicus	d__Archaea; p__Methanobacteriota; c__Methanococci; o__Methanococcales; f__Methanococcaceae; g__Methanotorris; s__Methanotorris formicicus
r__Root; d__Archaea; p__Euryarchaeota; c__Methanococci; o__Methanococcales; f__Methanocaldococcaceae; g__Methanotorris; s__Methanotorris igneus	d__Archaea; p__Methanobacteriota; c__Methanococci; o__Methanococcales; f__Methanococcaceae; g__Methanotorris; s__Methanotorris igneus
r__Root; d__Archaea; p__Euryarchaeota; c__Methanococci; o__Methanococcales; f__Methanococcaceae; g__Methanococcus; s__Methanococcus aeolicus	d__Archaea; p__Methanobacteriota; c__Methanococci; o__Methanococcales; f__Methanococcaceae; g__Methanothermococcus_A; s__Methanothermococcus_A aeolicus
r__Root; d__Archaea; p__Euryarchaeota; c__Methanococci; o__Methanococcales; f__Methanococcaceae; g__Methanococcus; s__Methanococcus maripaludis	d__Archaea; p__Methanobacteriota; c__Methanococci; o__Methanococcales; f__Methanococcaceae; g__Methanococcus; s__Methanococcus maripaludis
r__Root; d__Archaea; p__Euryarchaeota; c__Methanococci; o__Methanococcales; f__Methanococcaceae; g__Methanococcus; s__Methanococcus vannielii	d__Archaea; p__Methanobacteriota; c__Methanococci; o__Methanococcales; f__Methanococcaceae; g__Methanococcus; s__Methanococcus vannielii
r__Root; d__Archaea; p__Euryarchaeota; c__Methanococci; o__Methanococcales; f__Methanococcaceae; g__Methanococcus; s__Methanococcus voltae	d__Archaea; p__Methanobacteriota; c__Methanococci; o__Methanococcales; f__Methanococcaceae; g__Methanococcus; s__Methanococcus voltae
r__Root; d__Archaea; p__Euryarchaeota; c__Methanococci; o__Methanococcales; f__Methanococcaceae; g__Methanothermococcus; s__Methanothermococcus okinawensis	d__Archaea; p__Methanobacteriota; c__Methanococci; o__Methanococcales; f__Methanococcaceae; g__Methanothermococcus_A; s__Methanothermococcus_A okinawensis
r__Root; d__Archaea; p__Euryarchaeota; c__Methanococci; o__Methanococcales; f__Methanococcaceae; g__Methanothermococcus; s__Methanothermococcus thermolithotrophicus	d__Archaea; p__Methanobacteriota; c__Methanococci; o__Methanococcales; f__Methanococcaceae; g__Methanothermococcus; s__Methanothermococcus thermolithotrophicus
r__Root; d__Archaea; p__Euryarchaeota; c__Methanomicrobia	d__Archaea; p__Halobacteriota
r__Root; d__Archaea; p__Euryarchaeota; c__Methanomicrobia; o__Methanocellales; f__Methanocellaceae; g__Methanocella	d__Archaea; p__Halobacteriota; c__Methanocellia; o__Methanocellales; f__Methanocellaceae
r__Root; d__Archaea; p__Euryarchaeota; c__Methanomicrobia; o__Methanocellales; f__Methanocellaceae; g__Methanocella; s__Methanocella arvoryzae	d__Archaea; p__Halobacteriota; c__Methanocellia; o__Methanocellales; f__Methanocellaceae; g__Methanocella_A; s__Methanocella_A arvoryzae
r__Root; d__Archaea; p__Euryarchaeota; c__Methanomicrobia; o__Methanocellales; f__Methanocellaceae; g__Methanocella; s__Methanocella conradii	d__Archaea; p__Halobacteriota; c__Methanocellia; o__Methanocellales; f__Methanocellaceae; g__Methanocella; s__Methanocella conradii
r__Root; d__Archaea; p__Euryarchaeota; c__Methanomicrobia; o__Methanocellales; f__Methanocellaceae; g__Methanocella; s__Methanocella paludicola	d__Archaea; p__Halobacteriota; c__Methanocellia; o__Methanocellales; f__Methanocellaceae; g__Methanocella; s__Methanocella paludicola
r__Root; d__Archaea; p__Euryarchaeota; c__Methanomicrobia; o__Methanomicrobiales	d__Archaea; p__Halobacteriota; c__Methanomicrobia; o__Methanomicrobiales
r__Root; d__Archaea; p__Euryarchaeota; c__Methanomicrobia; o__Methanomicrobiales; f__Methanocorpusculaceae	d__Archaea; p__Halobacteriota; c__Methanomicrobia; o__Methanomicrobiales; f__Methanocorpusculaceae
r__Root; d__Archaea; p__Euryarchaeota; c__Methanomicrobia; o__Methanomicrobiales; f__Methanocorpusculaceae; g__Methanocorpusculum; s__Methanocorpusculum bavaricum	d__Archaea; p__Halobacteriota; c__Methanomicrobia; o__Methanomicrobiales; f__Methanocorpusculaceae; g__Methanocorpusculum; s__Methanocorpusculum parvum
r__Root; d__Archaea; p__Euryarchaeota; c__Methanomicrobia; o__Methanomicrobiales; f__Methanocorpusculaceae; g__Methanocorpusculum; s__Methanocorpusculum labreanum	d__Archaea; p__Halobacteriota; c__Methanomicrobia; o__Methanomicrobiales; f__Methanocorpusculaceae; g__Methanocorpusculum; s__Methanocorpusculum labreanum
r__Root; d__Archaea; p__Euryarchaeota; c__Methanomicrobia; o__Methanomicrobiales; f__Methanomicrobiaceae	d__Archaea; p__Halobacteriota; c__Methanomicrobia; o__Methanomicrobiales
r__Root; d__Archaea; p__Euryarchaeota; c__Methanomicrobia; o__Methanomicrobiales; f__Methanomicrobiaceae; g__Methanoculleus	d__Archaea; p__Halobacteriota; c__Methanomicrobia; o__Methanomicrobiales; f__Methanoculleaceae; g__Methanoculleus
r__Root; d__Archaea; p__Euryarchaeota; c__Methanomicrobia; o__Methanomicrobiales; f__Methanomicrobiaceae; g__Methanoculleus; s__Candidatus Methanoculleus thermohydrogenotrophicum	d__Archaea; p__Halobacteriota; c__Methanomicrobia; o__Methanomicrobiales; f__Methanoculleaceae; g__Methanoculleus; s__Methanoculleus thermohydrogenotrophicum
r__Root; d__Archaea; p__Euryarchaeota; c__Methanomicrobia; o__Methanomicrobiales; f__Methanomicrobiaceae; g__Methanoculleus; s__Methanoculleus bourgensis	d__Archaea; p__Halobacteriota; c__Methanomicrobia; o__Methanomicrobiales; f__Methanoculleaceae; g__Methanoculleus; s__Methanoculleus bourgensis
r__Root; d__Archaea; p__Euryarchaeota; c__Methanomicrobia; o__Methanomicrobiales; f__Methanomicrobiaceae; g__Methanoculleus; s__Methanoculleus marisnigri	d__Archaea; p__Halobacteriota; c__Methanomicrobia; o__Methanomicrobiales; f__Methanoculleaceae; g__Methanoculleus; s__Methanoculleus marisnigri
r__Root; d__Archaea; p__Euryarchaeota; c__Methanomicrobia; o__Methanomicrobiales; f__Methanomicrobiaceae; g__Methanoculleus; s__Methanoculleus sediminis	d__Archaea; p__Halobacteriota; c__Methanomicrobia; o__Methanomicrobiales; f__Methanoculleaceae; g__Methanoculleus; s__Methanoculleus sediminis
r__Root; d__Archaea; p__Euryarchaeota; c__Methanomicrobia; o__Methanomicrobiales; f__Methanomicrobiaceae; g__Methanoculleus; s__Methanoculleus sp. MH98A	d__Archaea; p__Halobacteriota; c__Methanomicrobia; o__Methanomicrobiales; f__Methanoculleaceae; g__Methanoculleus; s__Methanoculleus sp000691865
r__Root; d__Archaea; p__Euryarchaeota; c__Methanomicrobia; o__Methanomicrobiales; f__Methanomicrobiaceae; g__Methanoculleus; s__Methanoculleus thermophilus	d__Archaea; p__Halobacteriota; c__Methanomicrobia; o__Methanomicrobiales; f__Methanoculleaceae; g__Methanoculleus; s__Methanoculleus thermophilus
r__Root; d__Archaea; p__Euryarchaeota; c__Methanomicrobia; o__Methanomicrobiales; f__Methanomicrobiaceae; g__Methanofollis; s__Methanofollis liminatans	d__Archaea; p__Halobacteriota; c__Methanomicrobia; o__Methanomicrobiales; f__Methanofollaceae; g__Methanofollis; s__Methanofollis liminatans
r__Root; d__Archaea; p__Euryarchaeota; c__Methanomicrobia; o__Methanomicrobiales; f__Methanomicrobiaceae; g__Methanogenium	d__Archaea; p__Halobacteriota; c__Methanomicrobia; o__Methanomicrobiales; f__Methanomicrobiaceae; g__Methanogenium
r__Root; d__Archaea; p__Euryarchaeota; c__Methanomicrobia; o__Methanomicrobiales; f__Methanomicrobiaceae; g__Methanolacinia; s__Methanolacinia petrolearia	d__Archaea; p__Halobacteriota; c__Methanomicrobia; o__Methanomicrobiales; f__Methanomicrobiaceae; g__Methanolacinia; s__Methanolacinia petrolearia
r__Root; d__Archaea; p__Euryarchaeota; c__Methanomicrobia; o__Methanomicrobiales; f__Methanomicrobiaceae; g__Methanomicrobium; s__Methanomicrobium mobile	d__Archaea; p__Halobacteriota; c__Methanomicrobia; o__Methanomicrobiales; f__Methanomicrobiaceae; g__Methanomicrobium; s__Methanomicrobium mobile
r__Root; d__Archaea; p__Euryarchaeota; c__Methanomicrobia; o__Methanomicrobiales; f__Methanomicrobiaceae; g__Methanoplanus; s__Methanoplanus limicola	d__Archaea; p__Halobacteriota; c__Methanomicrobia; o__Methanomicrobiales; f__Methanomicrobiaceae; g__Methanoplanus; s__Methanoplanus limicola
r__Root; d__Archaea; p__Euryarchaeota; c__Methanomicrobia; o__Methanomicrobiales; f__Methanoregulaceae	d__Archaea; p__Halobacteriota; c__Methanomicrobia; o__Methanomicrobiales; f__Methanoregulaceae
r__Root; d__Archaea; p__Euryarchaeota; c__Methanomicrobia; o__Methanomicrobiales; f__Methanoregulaceae; g__Methanolinea	d__Archaea; p__Halobacteriota; c__Methanomicrobia; o__Methanomicrobiales; f__Methanoregulaceae
r__Root; d__Archaea; p__Euryarchaeota; c__Methanomicrobia; o__Methanomicrobiales; f__Methanoregulaceae; g__Methanolinea; s__Methanolinea sp. SDB	d__Archaea; p__Halobacteriota; c__Methanomicrobia; o__Methanomicrobiales; f__Methanoregulaceae; g__SD8; s__SD8 sp001412335
r__Root; d__Archaea; p__Euryarchaeota; c__Methanomicrobia; o__Methanomicrobiales; f__Methanoregulaceae; g__Methanolinea; s__Methanolinea tarda	d__Archaea; p__Halobacteriota; c__Methanomicrobia; o__Methanomicrobiales; f__Methanoregulaceae; g__Methanolinea; s__Methanolinea tarda
r__Root; d__Archaea; p__Euryarchaeota; c__Methanomicrobia; o__Methanomicrobiales; f__Methanoregulaceae; g__Methanoregula	d__Archaea; p__Halobacteriota; c__Methanomicrobia; o__Methanomicrobiales; f__Methanoregulaceae; g__Methanoregula
r__Root; d__Archaea; p__Euryarchaeota; c__Methanomicrobia; o__Methanomicrobiales; f__Methanoregulaceae; g__Methanoregula; s__Methanoregula boonei	d__Archaea; p__Halobacteriota; c__Methanomicrobia; o__Methanomicrobiales; f__Methanoregulaceae; g__Methanoregula; s__Methanoregula boonei
r__Root; d__Archaea; p__Euryarchaeota; c__Methanomicrobia; o__Methanomicrobiales; f__Methanoregulaceae; g__Methanoregula; s__Methanoregula formicica	d__Archaea; p__Halobacteriota; c__Methanomicrobia; o__Methanomicrobiales; f__Methanoregulaceae; g__Methanoregula; s__Methanoregula formicica
r__Root; d__Archaea; p__Euryarchaeota; c__Methanomicrobia; o__Methanomicrobiales; f__Methanoregulaceae; g__Methanosphaerula; s__Methanosphaerula palustris	d__Archaea; p__Halobacteriota; c__Methanomicrobia; o__Methanomicrobiales; f__Methanosphaerulaceae; g__Methanosphaerula; s__Methanosphaerula palustris
r__Root; d__Archaea; p__Euryarchaeota; c__Methanomicrobia; o__Methanomicrobiales; f__Methanospirillaceae	d__Archaea; p__Halobacteriota; c__Methanomicrobia; o__Methanomicrobiales; f__Methanospirillaceae
r__Root; d__Archaea; p__Euryarchaeota; c__Methanomicrobia; o__Methanomicrobiales; f__Methanospirillaceae; g__Methanospirillum	d__Archaea; p__Halobacteriota; c__Methanomicrobia; o__Methanomicrobiales; f__Methanospirillaceae; g__Methanospirillum
r__Root; d__Archaea; p__Euryarchaeota; c__Methanomicrobia; o__Methanomicrobiales; f__Methanospirillaceae; g__Methanospirillum; s__Methanospirillum hungatei	d__Archaea; p__Halobacteriota; c__Methanomicrobia; o__Methanomicrobiales; f__Methanospirillaceae; g__Methanospirillum; s__Methanospirillum hungatei
r__Root; d__Archaea; p__Euryarchaeota; c__Methanomicrobia; o__Methanophagales	d__Archaea; p__Halobacteriota; c__Syntropharchaeia; o__ANME-1
r__Root; d__Archaea; p__Euryarchaeota; c__Methanomicrobia; o__Methanosarcinales	d__Archaea; p__Halobacteriota; c__Methanosarcinia; o__Methanosarcinales
r__Root; d__Archaea; p__Euryarchaeota; c__Methanomicrobia; o__Methanosarcinales; f__Candidatus Methanoperedenaceae	d__Archaea; p__Halobacteriota; c__Methanosarcinia; o__Methanosarcinales; f__Methanoperedenaceae
r__Root; d__Archaea; p__Euryarchaeota; c__Methanomicrobia; o__Methanosarcinales; f__Candidatus Methanoperedenaceae; g__Candidatus Methanoperedens	d__Archaea; p__Halobacteriota; c__Methanosarcinia; o__Methanosarcinales; f__Methanoperedenaceae; g__Methanoperedens
r__Root; d__Archaea; p__Euryarchaeota; c__Methanomicrobia; o__Methanosarcinales; f__Candidatus Methanoperedenaceae; g__Candidatus Methanoperedens; s__Candidatus Methanoperedens nitroreducens	d__Archaea; p__Halobacteriota; c__Methanosarcinia; o__Methanosarcinales; f__Methanoperedenaceae; g__Methanoperedens; s__Methanoperedens nitroreducens
r__Root; d__Archaea; p__Euryarchaeota; c__Methanomicrobia; o__Methanosarcinales; f__Methanocomedenaceae; g__Methanomarinus	d__Archaea; p__Halobacteriota; c__Methanosarcinia; o__Methanosarcinales; f__Methanocomedenaceae; g__Methanomarinus
r__Root; d__Archaea; p__Euryarchaeota; c__Methanomicrobia; o__Methanosarcinales; f__Methanogasteraceae; g__Methanogaster	d__Archaea; p__Halobacteriota; c__Methanosarcinia; o__Methanosarcinales; f__Methanogasteraceae; g__Methanogaster
r__Root; d__Archaea; p__Euryarchaeota; c__Methanomicrobia; o__Methanosarcinales; f__Methanosaetaceae	d__Archaea; p__Halobacteriota; c__Methanosarcinia; o__Methanotrichales; f__Methanotrichaceae
r__Root; d__Archaea; p__Euryarchaeota; c__Methanomicrobia; o__Methanosarcinales; f__Methanosaetaceae; g__Methanothrix	d__Archaea; p__Halobacteriota; c__Methanosarcinia; o__Methanotrichales; f__Methanotrichaceae
r__Root; d__Archaea; p__Euryarchaeota; c__Methanomicrobia; o__Methanosarcinales; f__Methanosaetaceae; g__Methanothrix; s__Methanosaeta harundinacea	d__Archaea; p__Halobacteriota; c__Methanosarcinia; o__Methanotrichales; f__Methanotrichaceae; g__Methanothrix_A; s__Methanothrix_A harundinacea_E
r__Root; d__Archaea; p__Euryarchaeota; c__Methanomicrobia; o__Methanosarcinales; f__Methanosaetaceae; g__Methanothrix; s__Methanothrix soehngenii	d__Archaea; p__Halobacteriota; c__Methanosarcinia; o__Methanotrichales; f__Methanotrichaceae; g__Methanothrix; s__Methanothrix soehngenii
r__Root; d__Archaea; p__Euryarchaeota; c__Methanomicrobia; o__Methanosarcinales; f__Methanosaetaceae; g__Methanothrix; s__Methanothrix thermoacetophila	d__Archaea; p__Halobacteriota; c__Methanosarcinia; o__Methanotrichales; f__Methanotrichaceae; g__Methanothrix_B; s__Methanothrix_B thermoacetophila
r__Root; d__Archaea; p__Euryarchaeota; c__Methanomicrobia; o__Methanosarcinales; f__Methanosarcinaceae	d__Archaea; p__Halobacteriota; c__Methanosarcinia; o__Methanosarcinales; f__Methanosarcinaceae
r__Root; d__Archaea; p__Euryarchaeota; c__Methanomicrobia; o__Methanosarcinales; f__Methanosarcinaceae; g__Methanococcoides	d__Archaea; p__Halobacteriota; c__Methanosarcinia; o__Methanosarcinales; f__Methanosarcinaceae; g__Methanococcoides
r__Root; d__Archaea; p__Euryarchaeota; c__Methanomicrobia; o__Methanosarcinales; f__Methanosarcinaceae; g__Methanococcoides; s__Methanococcoides burtonii	d__Archaea; p__Halobacteriota; c__Methanosarcinia; o__Methanosarcinales; f__Methanosarcinaceae; g__Methanococcoides; s__Methanococcoides burtonii
r__Root; d__Archaea; p__Euryarchaeota; c__Methanomicrobia; o__Methanosarcinales; f__Methanosarcinaceae; g__Methanococcoides; s__Methanococcoides methylutens	d__Archaea; p__Halobacteriota; c__Methanosarcinia; o__Methanosarcinales; f__Methanosarcinaceae; g__Methanococcoides; s__Methanococcoides methylutens
r__Root; d__Archaea; p__Euryarchaeota; c__Methanomicrobia; o__Methanosarcinales; f__Methanosarcinaceae; g__Methanohalobium; s__Methanohalobium evestigatum	d__Archaea; p__Halobacteriota; c__Methanosarcinia; o__Methanosarcinales; f__Methanosarcinaceae; g__Methanohalobium; s__Methanohalobium evestigatum
r__Root; d__Archaea; p__Euryarchaeota; c__Methanomicrobia; o__Methanosarcinales; f__Methanosarcinaceae; g__Methanohalophilus; s__Methanohalophilus mahii	d__Archaea; p__Halobacteriota; c__Methanosarcinia; o__Methanosarcinales; f__Methanosarcinaceae; g__Methanohalophilus; s__Methanohalophilus mahii
r__Root; d__Archaea; p__Euryarchaeota; c__Methanomicrobia; o__Methanosarcinales; f__Methanosarcinaceae; g__Methanolobus	d__Archaea; p__Halobacteriota; c__Methanosarcinia; o__Methanosarcinales; f__Methanosarcinaceae; g__Methanolobus
r__Root; d__Archaea; p__Euryarchaeota; c__Methanomicrobia; o__Methanosarcinales; f__Methanosarcinaceae; g__Methanolobus; s__Methanolobus psychrophilus	d__Archaea; p__Halobacteriota; c__Methanosarcinia; o__Methanosarcinales; f__Methanosarcinaceae; g__Methanolobus; s__Methanolobus psychrophilus
r__Root; d__Archaea; p__Euryarchaeota; c__Methanomicrobia; o__Methanosarcinales; f__Methanosarcinaceae; g__Methanolobus; s__Methanolobus sp. T82-4	d__Archaea; p__Halobacteriota; c__Methanosarcinia; o__Methanosarcinales; f__Methanosarcinaceae; g__Methanolobus; s__Methanolobus sp001577565
r__Root; d__Archaea; p__Euryarchaeota; c__Methanomicrobia; o__Methanosarcinales; f__Methanosarcinaceae; g__Methanolobus; s__Methanolobus tindarius	d__Archaea; p__Halobacteriota; c__Methanosarcinia; o__Methanosarcinales; f__Methanosarcinaceae; g__Methanolobus; s__Methanolobus tindarius
r__Root; d__Archaea; p__Euryarchaeota; c__Methanomicrobia; o__Methanosarcinales; f__Methanosarcinaceae; g__Methanomethylovorans; s__Methanomethylovorans hollandica	d__Archaea; p__Halobacteriota; c__Methanosarcinia; o__Methanosarcinales; f__Methanosarcinaceae; g__Methanomethylovorans; s__Methanomethylovorans hollandica
r__Root; d__Archaea; p__Euryarchaeota; c__Methanomicrobia; o__Methanosarcinales; f__Methanosarcinaceae; g__Methanosalsum	d__Archaea; p__Halobacteriota; c__Methanosarcinia; o__Methanosarcinales; f__Methanosarcinaceae; g__Methanosalsum
r__Root; d__Archaea; p__Euryarchaeota; c__Methanomicrobia; o__Methanosarcinales; f__Methanosarcinaceae; g__Methanosalsum; s__Methanosalsum zhilinae	d__Archaea; p__Halobacteriota; c__Methanosarcinia; o__Methanosarcinales; f__Methanosarcinaceae; g__Methanosalsum; s__Methanosalsum zhilinae
r__Root; d__Archaea; p__Euryarchaeota; c__Methanomicrobia; o__Methanosarcinales; f__Methanosarcinaceae; g__Methanosarcina	d__Archaea; p__Halobacteriota; c__Methanosarcinia; o__Methanosarcinales; f__Methanosarcinaceae; g__Methanosarcina
r__Root; d__Archaea; p__Euryarchaeota; c__Methanomicrobia; o__Methanosarcinales; f__Methanosarcinaceae; g__Methanosarcina; s__Methanosarcina barkeri	d__Archaea; p__Halobacteriota; c__Methanosarcinia; o__Methanosarcinales; f__Methanosarcinaceae; g__Methanosarcina; s__Methanosarcina barkeri
r__Root; d__Archaea; p__Euryarchaeota; c__Methanomicrobia; o__Methanosarcinales; f__Methanosarcinaceae; g__Methanosarcina; s__Methanosarcina flavescens	d__Archaea; p__Halobacteriota; c__Methanosarcinia; o__Methanosarcinales; f__Methanosarcinaceae; g__Methanosarcina; s__Methanosarcina flavescens
r__Root; d__Archaea; p__Euryarchaeota; c__Methanomicrobia; o__Methanosarcinales; f__Methanosarcinaceae; g__Methanosarcina; s__Methanosarcina horonobensis	d__Archaea; p__Halobacteriota; c__Methanosarcinia; o__Methanosarcinales; f__Methanosarcinaceae; g__Methanosarcina; s__Methanosarcina horonobensis
r__Root; d__Archaea; p__Euryarchaeota; c__Methanomicrobia; o__Methanosarcinales; f__Methanosarcinaceae; g__Methanosarcina; s__Methanosarcina lacustris	d__Archaea; p__Halobacteriota; c__Methanosarcinia; o__Methanosarcinales; f__Methanosarcinaceae; g__Methanosarcina; s__Methanosarcina lacustris
r__Root; d__Archaea; p__Euryarchaeota; c__Methanomicrobia; o__Methanosarcinales; f__Methanosarcinaceae; g__Methanosarcina; s__Methanosarcina mazei	d__Archaea; p__Halobacteriota; c__Methanosarcinia; o__Methanosarcinales; f__Methanosarcinaceae; g__Methanosarcina; s__Methanosarcina mazei
r__Root; d__Archaea; p__Euryarchaeota; c__Methanomicrobia; o__Methanosarcinales; f__Methanosarcinaceae; g__Methanosarcina; s__Methanosarcina siciliae	d__Archaea; p__Halobacteriota; c__Methanosarcinia; o__Methanosarcinales; f__Methanosarcinaceae; g__Methanosarcina; s__Methanosarcina siciliae
r__Root; d__Archaea; p__Euryarchaeota; c__Methanomicrobia; o__Methanosarcinales; f__Methanosarcinaceae; g__Methanosarcina; s__Methanosarcina sp. 2.H.A.1B.4	d__Archaea; p__Halobacteriota; c__Methanosarcinia; o__Methanosarcinales; f__Methanosarcinaceae; g__Methanosarcina; s__Methanosarcina sp000979455
r__Root; d__Archaea; p__Euryarchaeota; c__Methanomicrobia; o__Methanosarcinales; f__Methanosarcinaceae; g__Methanosarcina; s__Methanosarcina sp. Kolksee	d__Archaea; p__Halobacteriota; c__Methanosarcinia; o__Methanosarcinales; f__Methanosarcinaceae; g__Methanosarcina; s__Methanosarcina vacuolata
r__Root; d__Archaea; p__Euryarchaeota; c__Methanomicrobia; o__Methanosarcinales; f__Methanosarcinaceae; g__Methanosarcina; s__Methanosarcina sp. MTP4	d__Archaea; p__Halobacteriota; c__Methanosarcinia; o__Methanosarcinales; f__Methanosarcinaceae; g__MTP4; s__MTP4 sp000970045
r__Root; d__Archaea; p__Euryarchaeota; c__Methanomicrobia; o__Methanosarcinales; f__Methanosarcinaceae; g__Methanosarcina; s__Methanosarcina sp. WH1	d__Archaea; p__Halobacteriota; c__Methanosarcinia; o__Methanosarcinales; f__Methanosarcinaceae; g__Methanosarcina; s__Methanosarcina sp000969965
r__Root; d__Archaea; p__Euryarchaeota; c__Methanomicrobia; o__Methanosarcinales; f__Methanosarcinaceae; g__Methanosarcina; s__Methanosarcina vacuolata	d__Archaea; p__Halobacteriota; c__Methanosarcinia; o__Methanosarcinales; f__Methanosarcinaceae; g__Methanosarcina; s__Methanosarcina vacuolata
r__Root; d__Archaea; p__Euryarchaeota; c__Methanomicrobia; o__Methanosarcinales; f__Methanosarcinaceae; g__Methanovorans	d__Archaea; p__Halobacteriota; c__Methanosarcinia; o__Methanosarcinales; f__Methanosarcinaceae; g__Methanovorans
r__Root; d__Archaea; p__Euryarchaeota; c__Methanonatronarchaeia; o__Methanonatronarchaeales; f__Methanonatronarchaeaceae; g__Candidatus Methanohalarchaeum; s__Candidatus Methanohalarchaeum thermophilum	d__Archaea; p__Halobacteriota; c__Methanonatronarchaeia; o__Methanonatronarchaeales; f__Methanohalarchaeaceae; g__Methanohalarchaeum; s__Methanohalarchaeum thermophilum
r__Root; d__Archaea; p__Euryarchaeota; c__Methanonatronarchaeia; o__Methanonatronarchaeales; f__Methanonatronarchaeaceae; g__Methanonatronarchaeum; s__Methanonatronarchaeum thermophilum	d__Archaea; p__Halobacteriota; c__Methanonatronarchaeia; o__Methanonatronarchaeales; f__Methanonatronarchaeaceae; g__Methanonatronarchaeum; s__Methanonatronarchaeum thermophilum
r__Root; d__Archaea; p__Euryarchaeota; c__Methanopyri; o__Methanopyrales; f__Methanopyraceae	d__Archaea; p__Methanobacteriota; c__Methanopyri; o__Methanopyrales; f__Methanopyraceae
r__Root; d__Archaea; p__Euryarchaeota; c__Methanopyri; o__Methanopyrales; f__Methanopyraceae; g__Methanopyrus; s__Methanopyrus kandleri	d__Archaea; p__Methanobacteriota; c__Methanopyri; o__Methanopyrales; f__Methanopyraceae; g__Methanopyrus; s__Methanopyrus kandleri
r__Root; d__Archaea; p__Euryarchaeota; c__Thermoplasmata	d__Archaea; p__Thermoplasmatota; c__Thermoplasmata
r__Root; d__Archaea; p__Euryarchaeota; c__Thermoplasmata; o__Methanomassiliicoccales	d__Archaea; p__Thermoplasmatota; c__Thermoplasmata; o__Methanomassiliicoccales
r__Root; d__Archaea; p__Euryarchaeota; c__Thermoplasmata; o__Methanomassiliicoccales; f__Candidatus Methanomethylophilaceae; g__Candidatus Methanomethylophilus; s__Candidatus Methanomethylophilus alvus	d__Archaea; p__Thermoplasmatota; c__Thermoplasmata; o__Methanomassiliicoccales; f__Methanomethylophilaceae; g__Methanomethylophilus; s__Methanomethylophilus alvus
r__Root; d__Archaea; p__Euryarchaeota; c__Thermoplasmata; o__Methanomassiliicoccales; f__Candidatus Methanomethylophilaceae; g__Candidatus Methanomethylophilus; s__Candidatus Methanomethylophilus sp. 1R26	d__Archaea; p__Thermoplasmatota; c__Thermoplasmata; o__Methanomassiliicoccales; f__Methanomethylophilaceae; g__Methanomethylophilus; s__Methanomethylophilus sp001481295
r__Root; d__Archaea; p__Euryarchaeota; c__Thermoplasmata; o__Methanomassiliicoccales; f__Methanomassiliicoccaceae	d__Archaea; p__Thermoplasmatota; c__Thermoplasmata; o__Methanomassiliicoccales; f__Methanomassiliicoccaceae
r__Root; d__Archaea; p__Euryarchaeota; c__Thermoplasmata; o__Methanomassiliicoccales; f__Methanomassiliicoccaceae; g__Candidatus Methanoplasma	d__Archaea; p__Thermoplasmatota; c__Thermoplasmata; o__Methanomassiliicoccales; f__Methanomethylophilaceae; g__Methanoplasma
r__Root; d__Archaea; p__Euryarchaeota; c__Thermoplasmata; o__Methanomassiliicoccales; f__Methanomassiliicoccaceae; g__Candidatus Methanoplasma; s__Candidatus Methanoplasma termitum	d__Archaea; p__Thermoplasmatota; c__Thermoplasmata; o__Methanomassiliicoccales; f__Methanomethylophilaceae; g__Methanoplasma; s__Methanoplasma termitum
r__Root; d__Archaea; p__Euryarchaeota; c__Thermoplasmata; o__Methanomassiliicoccales; f__Methanomassiliicoccaceae; g__Methanomassiliicoccus	d__Archaea; p__Thermoplasmatota; c__Thermoplasmata; o__Methanomassiliicoccales; f__Methanomassiliicoccaceae
r__Root; d__Archaea; p__Euryarchaeota; c__Thermoplasmata; o__Methanomassiliicoccales; f__Methanomassiliicoccaceae; g__Methanomassiliicoccus; s__Candidatus Methanomassiliicoccus intestinalis	d__Archaea; p__Thermoplasmatota; c__Thermoplasmata; o__Methanomassiliicoccales; f__Methanomassiliicoccaceae; g__Methanomassiliicoccus; s__Methanomassiliicoccus intestinalis
r__Root; d__Archaea; p__Euryarchaeota; c__Thermoplasmata; o__Methanomassiliicoccales; f__Methanomassiliicoccaceae; g__Methanomassiliicoccus; s__Methanomassiliicoccus luminyensis	d__Archaea; p__Thermoplasmatota; c__Thermoplasmata; o__Methanomassiliicoccales; f__Methanomassiliicoccaceae; g__Methanomassiliicoccus; s__Methanomassiliicoccus luminyensis
r__Root; d__Archaea; p__Euryarchaeota; c__Thermoplasmata; o__Thermoplasmatales	d__Archaea; p__Thermoplasmatota; c__Thermoplasmata; o__Thermoplasmatales